111111111
10P000011
10C0000C1
100011001
10001E001
100000001
100C00001
1C0000001
111111111
