11111111111111111111111111111111111
1000000000000000000000000C000000001
1P0C001E0000000000000000000000C0001
1000000000000000000000C000000000001
100000000000000000000000000000C0001
11111111111111111111111111111111111